

















..........F
.........**
......E....
.....****..
..S........
****.......